XXXXXXXXXXXXXXXXXXXXXX
X2212222111X122211b21X
X12111X2111XXXXX11233X
X1232232111X111111111X
X1XXXXX2XXXXXXXX11211X
XXX21XX1111X111111211X
X2X2121XX1XX111111111X
X1X112X1e11XXXXX12XXXX
X222111X121X11221X2c2X
X11a112X1d2X12231X233X
X3212321211112321X112X
XXXXXXXXXXXXXXXXXXXXXX
